sort	Filter	All Endpoints
sort_type	Filter	All Endpoints
after	Integer	All Endpoints
before	Integer	All Endpoints
after_id	Integer	All Endpoints
before_id	Integer	All Endpoints
created_utc	Integer	All Endpoints
score	Integer	All Endpoints
gilded	Integer	All Endpoints
edited	Boolean	All Endpoints
author	Keyword	All Endpoints
subreddit	Keyword	All Endpoints
distinguished	Keyword	All Endpoints
retrieved_on	Integer	All Endpoints
last_updated	Integer	All Endpoints
q	string	All Endpoints
id	Integer	All Endpoints
metadata	Utility	All Endpoints
unique	Filter	All Endpoints
pretty	Filter	All Endpoints
html_decode	Filter	All Endpoints
permalink	Keyword	All Endpoints
user_removed	Boolean	All Endpoints
mod_removed	Boolean	All Endpoints
subreddit_type	keyword	All Endpoints
author_flair_css_class	keyword	All Endpoints
author_flair_text	keyword	All Endpoints
reply_delay	Integer	Comment Endpoint
nest_level	Integer	Comment Endpoint
sub_reply_delay	Integer	Comment Endpoint
utc_hour_of_week 	Integer	Comment Endpoint
link_id 	Integer	Comment Endpoint
parent_id 	Integer	Comment Endpoint
over_18	Boolean	Submission Endpoint
locked	Boolean	Submission Endpoint
spoiler	Boolean	Submission Endpoint
is_video	Boolean	Submission Endpoint
is_self	Boolean	Submission Endpoint
is_original_content	Boolean	Submission Endpoint
is_reddit_media_domain	Boolean	Submission Endpoint
whitelist_status	Keyword	Submission Endpoint
parent_whitelist_status	Keyword	Submission Endpoint
is_crosspostable	Boolean	Submission Endpoint
can_gild	Boolean	Submission Endpoint
suggested_sort	Keyword	Submission Endpoint
no_follow	Boolean	Submission Endpoint
send_replies	Boolean	Submission Endpoint
link_flair_css_class	Keyword	Submission Endpoint
link_flair_text	Keyword	Submission Endpoint
num_crossposts	Integer	Submission Endpoint
title	String	Submission Endpoint
selftext	String	Submission Endpoint
quarantine	Boolean	Submission Endpoint
pinned	Boolean	Submission Endpoint
stickied	Boolean	Submission Endpoint
category	Keyword	Submission Endpoint
contest_mode	Boolean	Submission Endpoint
subreddit_subscribers	Integer	Submission Endpoint
url	Keyword	Submission Endpoint
domain	Keyword	Submission Endpoint
thumbnail	Keyword	Submission Endpoint
description	String	Subreddit Endpoint
public_description 	String	Subreddit Endpoint
title 	String	Subreddit Endpoint
header_title 	String	Subreddit Endpoint
submit_text	String	Subreddit Endpoint
subscribers 	Integer	Subreddit Endpoint
comment_score_hide_mins 	Integer	Subreddit Endpoint
suggested_comment_sort 	Keyword	Subreddit Endpoint
submission_type	Keyword	Subreddit Endpoint
spoilers_enabled	Boolean	Subreddit Endpoint
lang	Keyword	Subreddit Endpoint
is_enrolled_in_new_modmail	Boolean	Subreddit Endpoint
audience_target	Keyword	Subreddit Endpoint
allow_videos	Boolean	Subreddit Endpoint
allow_images	Boolean	Subreddit Endpoint
allow_videogifs	Boolean	Subreddit Endpoint
advertiser_category	Keyword	Subreddit Endpoint
hide_ad	Boolean	Subreddit Endpoint
subreddit_type	Keyword	Subreddit Endpoint
wiki_enabled	Boolean	Subreddit Endpoint
user_sr_theme_enabled	Boolean	Subreddit Endpoint
whitelist_status	Keyword	Subreddit Endpoint
submit_link_label	Keyword	Subreddit Endpoint
show_media_preview	Boolean	Subreddit Endpoint